#####################
#                   #
S                   P
#                   #
#                   #
#####C########L######