###########################
#                         #
#                         #
S                         P
#                         #
#                         #
#                         #
#                         #
########C#########L########