##########################
#                        #
#                        #
S                        P
#                        #
#                        #
##########################